9, 6
0, 2
0 0 0 0 0 0
0 X X X 0 0
0 X X X D 0
0 X X X 0 0
0 0 0 0 P 0
0 X X X X 0
0 X X X X 0
0 X X X X 0
0 0 0 G 0 0